maverick	başına buyruk	he is a bit of maverick
make	yapmak	making up with someone
sex	seks	i just had sex
better off	iyi edersin, daha iyi olur	You'd be better off going there.
indulgence	müsamaha, kendini şımartma	There was a lot of indulgences yesterday.
put off	ertelemek, soğutmak	It puts me off, when you pick nose.
objective	maksat, hedef	
choke	boğmak	
drawer	çekmece	
coyote	çakal	
corp	birlik, heyet	
hoard	stoklamak	You don't need to hoard spagettis.
landmark	dönüm noktası	
ripple	dalgacık	
chip	yonga	
companionship	dostluk	
way to go	bravo, yürü be!	
pawn	piyon	
doggy bag	köpek için alınan artık yemek	
frontier	sınır, hudut	
bury	gömmek	
subsequent	müteakip	
pigeon	güvercin	
hollow	oyuk	
chip in	bölüşmek	chip in for the gift
spoiled	şımarık	
crawl	emeklemek	
preclude	imkansız kılmak	
accordingly	dolayısıyla	
novice	acemi, toy	
tame	evcil, evcilleştirmek	
pillage	yağmalamak	
catch up	yakalamak	I will catch up with you later.
rewind	geri sarmak	rewind the tape
outrage	kanunsuzluk, zorbalık	
manure	gübre	
appealing	cazibeli, çekici	
beforehand	öncesinde	discuss it beforehand
dilute	seyreltmek	diluted vinegar
saturate	doyurmak, içine işlemek, yedirmek	room is saturated with perfume
up against	karşısında olmak	You don't understand what i am up against!
eligible	seçkin, nitelikli, hak sahibi	
utilize	yararlanmak	
mirage	serap	
oasis	vaha	
herd	sürü	
yearn	hasret	
bloom	çiçek açmak	
consent	razı olmak	
conforming	uygun olan	
divine	ulvi	
supremacy	üstünlük	white supremacy
conspiracy	komplo (teori)	
recruiter	işe alım personeli	recruitment
sanitize	sterilize etmek	
ensuing	ardından gelen	
benchmark	karşılaştırma, değerlendirme	
tune	ayarlama, akortlama	
latitude	enlem	
furniture	mobilya	
dignity	itibar	
mug	soymak, kapkaç	
teasing	sataşmak	teasing animals
urge	dürtü	
cut to the chase	sadede gelmek	
dividend	pay	
prohibited	yasaklanmış	
deliberate	kasti	
conduct	yöneltmek	
blush	kızarmak (yüzü)	
prolong	sürdürmek, uzatmak	
foremost	önde gelen	
justification	gerekçelendirme, sebep gösterme	
flattering	pohpohlama	
coerce	zorlamak, baskı yapmak	
take into account	hesaplamak, göz önüne almak	
anticipate	sezmek, önceden tahmin etmek	
manner	biçim	in a friendly manner
peer	eş, akran	
cruel	zalim	
holding a stereotype	stereotiplemek	He holds a stereotype about Turkey, that they are violent
spatial	uzaysal	
literate	okur yazar	
perceive	idrak etmek	
autonomy	özerklik	
delicate	narin, titiz	delicate yet masculine
precision	kesinlik	
bizarre	tuhaf, acayip	
inferior	alt	inferior X superior
aptitude	kabiliyet, eğilim	
unprecedented	eşsiz, emsalsiz	
poverty	sefalet	
abruptly	birdenbire	
obscene	müstehcen	obscene gestures
prevalent	hakim, yaygın, dominant	
contend	uğraşmak, savaşmak	
seizure	nöbet	
limb	uzuv, kol, bacak	
limbo	araf, belirsizlik	I am in limbo
explicit	açık, net, belirgin	
implicit	imalı	
mashed	ezilmiş, püre	
acquisition	edinme, kazanma	
opposed	karşıt, zıt	
intriguing	entrikalı, şaşırtıcı	
diminish	azalmak	
glossary	terimler sözlüğü	
collate	dizmek, sıraya koymak	
sovereign	egemenlik, egemen	
credential	güven belgesi	
steward	kahya	
misdemeanor	kabahat	
consolidate	birleşmiş, işler yoluna girmiş	
unsettled	tedirgin	
pasture	çayır, otlak	
grazing	otlatmak	
cattle	sığır	
depleted	tükenmek	
stock exchange	borsa	
genuine	özgün, samimi, hakiki	
legislative	yasama, yasamayla ilgili	
incentive	teşvik	
revenue	hasılat, gelir	
asset	varlık, kazanç	
